4 4 4 4 4 4 4 4 4 4 6 4 4 4 6 4 4 4 4 4 4 6 4 6 4 4 4 4 6 4 4 4 4 4 6 4 4 4 4 4 4 6 4 4 4 4 6 4 4 4
4 6 4 4 6 4 4 6 4 4 4 6 4 4 6 4 4 4 4 4 4 4 4 4 4 6 4 6 4 6 4 4 6 4 4 4 4 4 4 4 4 6 4 4 6 4 4 4 6 4
4 4 6 6 4 6 4 4 4 6 4 4 4 6 4 4 4 4 4 6 0 2 2 2 2 2 0 4 6 4 4 4 4 4 4 4 6 4 4 6 4 6 6 4 4 6 4 4 4 4
4 4 4 6 4 4 4 4 4 6 6 4 4 4 6 4 4 4 6 4 2 2 2 2 2 2 2 6 4 4 6 4 4 4 4 4 4 4 4 4 4 4 6 4 6 4 4 4 6 4
4 4 4 4 6 4 4 6 4 4 4 4 4 6 4 4 4 4 6 4 2 2 2 2 2 2 2 4 6 4 4 4 4 4 4 4 4 6 4 4 4 4 6 4 6 4 4 6 4 4
4 4 4 4 6 4 4 4 4 4 4 4 6 4 6 4 4 4 4 4 2 2 2 2 2 2 2 4 4 6 6 4 4 4 4 4 4 4 4 4 6 4 4 6 4 4 4 4 4 4
4 4 4 4 4 6 4 4 1 1 1 1 1 4 4 6 4 4 4 4 6 2 2 2 2 2 6 4 4 4 6 4 4 4 4 6 4 4 6 4 4 4 4 4 4 6 4 4 4 4
4 4 4 4 4 4 6 6 1 3 3 3 1 6 4 4 4 4 6 4 0 0 0 5 0 0 0 4 4 6 4 4 6 0 5 5 5 5 5 4 5 4 6 4 4 4 6 4 4 4
4 4 6 4 4 4 6 6 1 3 3 3 1 4 4 4 6 4 4 4 4 0 0 0 0 0 4 4 4 4 4 4 4 4 5 5 5 5 5 5 5 5 4 4 4 4 4 4 4 4
4 6 4 6 6 4 4 4 1 3 3 3 1 4 4 4 4 4 4 4 4 4 0 0 0 4 6 4 4 4 4 4 4 4 4 5 5 5 5 5 5 4 5 4 6 4 4 6 4 4
4 4 4 4 6 4 6 4 1 3 3 3 1 6 4 4 4 4 6 4 6 4 4 5 4 6 4 4 4 4 4 4 6 4 5 5 5 5 5 5 5 5 4 4 4 4 6 4 4 6
4 4 6 4 4 6 4 4 1 1 0 1 1 4 6 4 4 4 4 4 4 4 4 5 4 4 4 4 6 4 4 6 4 6 5 5 5 5 5 5 5 5 4 4 4 4 6 4 6 6
4 4 6 4 4 6 4 4 4 6 0 4 4 6 4 4 6 4 4 4 4 4 4 5 4 4 6 4 4 4 4 4 4 4 6 5 5 5 6 5 5 4 4 6 4 4 4 4 4 4
4 6 4 4 6 4 4 4 4 4 0 4 4 4 4 6 4 4 4 6 4 6 4 5 4 4 4 4 4 4 4 4 6 4 4 4 4 4 5 4 4 4 4 4 4 4 4 4 4 4
4 4 6 4 4 4 6 4 4 4 0 4 4 4 4 4 4 6 4 4 6 4 4 5 4 4 4 4 4 4 4 4 4 4 4 4 4 4 5 4 4 4 4 4 4 4 4 6 4 4
4 4 4 4 4 4 4 4 0 0 0 4 4 4 4 4 4 4 4 6 4 6 6 5 4 4 6 4 4 4 4 4 4 4 4 4 4 6 5 4 4 4 6 4 4 4 4 4 4 6
4 4 4 4 4 4 4 4 0 6 4 4 4 4 4 4 4 4 4 4 4 4 4 5 4 6 4 4 4 4 4 6 4 4 4 4 4 5 4 4 4 4 4 4 6 4 4 4 4 4
4 4 4 6 4 4 4 4 0 4 4 4 4 4 4 4 6 4 4 4 4 6 0 5 0 6 4 4 4 4 4 6 4 4 4 4 5 5 5 4 4 4 4 4 4 4 4 4 4 4
4 6 4 6 4 4 4 4 0 4 4 4 4 4 4 4 4 4 4 4 4 0 0 5 6 0 4 4 4 4 4 4 4 6 4 4 5 4 4 4 4 4 4 4 4 4 4 4 6 4
4 4 4 4 4 4 4 4 0 4 4 4 6 4 4 4 4 4 6 6 0 0 0 5 0 0 0 6 6 4 4 4 4 4 4 5 5 4 4 4 4 4 6 4 4 4 4 6 4 4
4 4 4 4 4 4 4 4 0 4 4 4 4 4 6 4 4 4 6 6 0 0 0 5 0 0 0 6 6 4 4 4 4 4 4 5 5 4 4 4 4 4 4 4 4 4 4 4 4 4
4 4 4 4 4 4 4 4 0 4 4 4 5 5 5 5 5 5 5 5 5 5 5 5 5 5 5 5 5 5 5 5 5 5 5 5 5 4 4 4 4 4 4 4 4 4 4 4 4 4
4 4 4 4 4 4 4 4 0 4 4 4 0 4 6 4 4 4 4 6 0 0 0 5 0 0 0 6 4 4 4 4 4 4 4 4 5 4 4 4 4 4 4 4 4 4 4 4 4 4
4 4 4 4 4 4 4 4 0 4 4 4 0 4 4 4 4 4 4 4 4 0 0 5 0 0 4 4 4 4 4 4 4 4 4 4 5 4 4 4 4 4 4 4 4 4 4 4 4 4
4 4 4 4 4 4 4 4 0 4 4 4 0 4 4 4 6 4 4 4 4 6 0 5 0 6 4 4 4 4 6 4 4 4 4 4 5 4 4 4 4 4 4 4 4 4 4 4 4 4
4 4 4 4 4 4 4 4 0 4 4 4 0 0 0 4 4 4 4 4 4 4 4 5 4 4 4 4 4 4 4 4 4 4 4 4 5 4 4 4 4 4 4 4 4 4 4 4 4 4
4 4 4 4 4 4 4 4 0 4 4 4 4 4 0 4 4 6 4 4 4 4 4 5 4 4 4 4 6 4 4 4 4 4 4 4 5 4 4 4 4 4 4 4 4 4 4 4 4 4
4 4 4 4 4 4 4 4 0 4 4 4 4 4 0 4 4 4 4 4 4 4 4 5 4 4 4 0 4 4 4 4 4 4 4 0 5 4 4 4 4 4 4 4 4 4 4 4 4 4
4 4 4 6 4 6 4 4 0 4 4 4 4 4 0 4 4 4 4 4 4 4 4 5 4 4 4 4 4 4 0 4 4 4 4 4 5 4 4 4 4 4 4 4 4 4 4 4 4 4
4 4 4 4 4 4 4 4 0 0 0 0 0 0 0 4 4 6 4 4 4 4 4 5 4 4 4 4 4 4 0 4 4 4 4 4 5 4 4 4 4 4 4 4 4 4 4 4 4 4
4 4 4 4 4 4 4 4 0 0 0 0 0 0 0 4 4 4 4 4 4 4 4 5 4 4 4 4 4 4 6 4 4 4 4 4 0 4 4 4 4 4 4 4 4 4 4 4 4 4
4 4 4 4 6 4 4 4 0 0 0 0 0 0 0 4 4 4 4 4 4 4 4 5 4 4 4 4 4 4 4 4 4 4 4 0 0 0 4 4 4 4 4 4 4 4 4 4 4 4
4 4 4 4 4 4 4 4 0 0 0 0 0 0 0 4 4 4 4 6 4 4 4 5 4 4 4 6 4 4 4 6 4 4 4 0 0 0 4 4 4 4 4 4 4 4 4 4 4 4
4 4 4 4 4 4 4 4 0 0 0 0 0 0 0 4 4 4 4 4 4 4 4 5 4 4 4 4 4 4 4 4 4 4 4 0 0 0 4 4 4 4 4 4 4 4 4 4 4 4
4 4 4 4 4 4 4 4 0 0 0 0 0 0 0 4 4 4 4 4 4 4 4 5 4 4 4 4 4 4 4 4 4 4 4 0 0 0 4 4 4 4 4 4 4 4 4 4 4 4
4 4 4 4 4 4 4 4 4 4 4 4 4 4 4 4 4 4 4 4 4 4 4 5 4 4 4 4 4 4 4 4 4 4 4 0 0 0 4 4 4 4 4 4 4 4 4 4 4 4
4 4 4 4 4 4 4 4 4 4 4 4 4 4 4 4 4 4 4 0 0 0 0 0 0 0 0 4 4 4 4 4 4 4 0 0 0 0 0 4 4 4 4 4 4 4 4 4 4 4
4 4 4 4 4 4 4 4 4 4 4 4 4 4 4 4 4 4 0 0 0 0 0 0 0 0 0 0 4 4 0 4 4 0 0 0 0 0 0 4 4 4 4 4 4 4 4 4 4 4
4 4 4 4 4 4 4 4 4 4 4 4 4 4 4 4 4 4 0 0 0 0 0 0 0 0 0 0 4 4 4 4 0 0 0 0 0 0 0 4 4 4 4 4 4 4 4 4 4 4
4 4 4 4 6 6 4 4 4 4 4 4 4 0 4 4 4 4 0 0 0 0 0 0 0 0 0 0 0 4 4 4 0 0 0 0 0 4 0 4 4 4 4 4 4 4 4 4 4 4
4 4 4 4 4 4 4 4 4 4 4 4 4 4 4 4 4 4 0 0 0 0 0 0 0 0 0 0 0 0 0 0 0 0 4 0 0 0 0 4 4 4 4 4 4 4 4 4 4 4
4 4 4 4 4 4 4 4 4 4 4 6 4 0 4 4 4 4 4 0 0 0 0 0 0 0 0 4 4 4 4 0 0 0 0 0 0 0 0 4 4 4 4 4 4 4 4 4 4 4
4 4 4 4 4 4 4 4 4 4 4 4 4 4 4 4 4 4 4 4 0 0 0 0 0 0 4 4 4 4 4 0 0 4 0 0 4 0 0 4 4 4 4 4 4 4 4 4 4 4
4 4 4 4 4 4 4 4 4 4 4 4 4 4 4 4 4 4 4 4 4 4 4 4 4 4 4 4 4 4 4 4 0 0 0 0 0 0 4 4 4 4 4 4 4 4 4 4 4 4
4 4 6 4 4 6 4 4 4 4 4 4 4 4 4 4 4 4 4 4 4 4 4 4 4 4 4 4 4 4 4 4 4 4 4 4 4 4 4 4 4 4 4 4 4 4 4 4 4 4
4 6 4 4 4 4 6 4 4 4 6 4 4 4 4 4 4 4 4 4 4 4 4 4 4 4 4 4 4 4 4 4 4 4 4 4 4 4 4 4 4 4 4 4 4 4 4 4 4 4
4 4 4 4 6 4 4 4 4 4 4 4 4 4 4 4 4 4 4 4 4 4 4 4 4 4 4 4 4 4 4 4 4 4 4 4 4 4 4 4 4 4 4 4 4 4 4 4 4 4
4 4 4 4 4 4 4 4 4 4 4 4 4 4 4 4 4 4 4 4 4 4 4 4 4 4 4 4 4 4 4 4 4 4 4 4 4 4 4 4 4 4 4 4 4 4 4 4 4 4
4 4 4 4 4 4 4 4 4 4 4 4 6 4 4 4 4 4 4 4 6 4 4 4 4 4 4 4 4 4 4 4 6 4 4 4 4 4 4 4 4 4 4 4 4 4 4 4 4 4
4 4 4 6 4 4 6 4 4 4 4 4 4 4 4 4 4 4 4 4 4 4 4 4 4 4 4 4 4 4 4 4 4 4 4 4 4 4 4 4 4 4 4 4 4 4 4 4 4 4
