4 4 4 4 4 4 4 4 4 4 4 4 4 4 4 4 4 4 4 4 4 4 6 6 4 4 4 4 4 4 4 4 4 4 4 4 4 4 4 4 4 4 4 4 4 4 4 4 9 9 
4 4 4 4 4 4 4 4 4 4 4 6 6 4 4 4 4 4 4 4 4 4 4 4 4 4 4 4 4 4 4 4 4 4 4 4 8 8 8 4 4 6 6 6 6 4 4 4 9 9 
4 4 4 6 4 4 4 12 4 4 4 6 6 4 4 4 4 4 4 4 6 2 2 2 2 2 6 4 4 4 9 9 4 4 4 4 8 8 8 4 4 4 6 6 6 4 4 4 9 9 
4 4 4 6 6 4 12 12 12 4 4 4 4 4 4 4 4 4 4 6 2 2 2 2 2 2 2 6 4 4 9 4 10 4 4 4 4 4 4 4 4 4 4 6 6 4 4 4 4 4 
12 12 4 6 4 4 4 4 4 4 4 4 4 4 4 4 4 4 6 4 2 2 2 2 2 2 2 4 6 4 4 4 4 4 4 10 10 4 4 4 4 4 4 4 4 4 4 4 4 4 
12 12 4 4 4 4 4 4 4 4 4 4 4 4 4 4 4 4 4 4 2 2 2 2 2 2 2 4 4 4 4 4 4 4 4 4 4 4 4 4 4 4 4 4 4 4 4 4 4 4 
4 4 4 4 4 4 4 4 1 1 1 1 1 4 4 4 4 4 4 4 4 2 2 2 2 2 4 4 4 4 4 4 4 6 4 4 4 4 4 4 4 4 4 6 4 4 12 4 4 4 
4 4 4 4 4 4 4 6 1 3 3 3 1 6 4 4 10 10 4 4 0 0 0 5 0 0 0 4 4 4 4 4 4 7 7 5 5 5 5 5 5 4 4 4 4 4 12 4 4 4 
4 4 4 4 4 4 4 8 1 3 3 3 1 8 4 4 10 10 4 4 4 0 0 0 0 0 4 4 4 4 12 4 4 4 5 5 5 5 5 5 11 5 4 4 4 4 12 4 6 4 
4 6 6 4 4 4 4 4 1 3 3 3 1 4 4 4 4 4 4 4 4 4 9 0 9 4 4 4 4 4 12 12 4 4 5 5 5 5 5 5 5 5 4 4 6 4 4 4 4 4 
4 4 4 4 4 4 4 4 1 3 3 3 1 4 4 4 4 4 4 4 6 4 4 5 4 6 4 4 4 4 4 4 4 4 5 5 11 5 5 5 5 5 4 4 4 4 4 4 10 4 
4 4 12 12 12 4 4 4 1 1 0 1 1 4 4 4 4 4 4 4 4 4 4 5 4 4 4 4 6 4 4 4 4 4 5 5 5 5 5 5 5 5 4 4 4 6 4 4 10 4 
4 4 4 4 4 6 6 4 8 7 0 7 8 4 6 6 4 4 4 4 4 4 4 5 4 4 4 4 4 4 4 4 4 4 4 5 5 5 5 5 5 4 4 4 4 4 4 4 10 4 
4 4 4 4 4 4 4 4 4 4 0 4 4 4 11 11 4 4 4 4 4 4 4 5 4 9 9 4 4 4 4 4 4 4 4 4 4 4 5 4 4 4 4 4 4 4 4 4 4 4 
4 4 6 6 4 4 4 11 4 4 0 4 4 4 11 11 4 4 4 4 4 4 4 5 4 9 9 4 4 4 4 4 6 6 4 4 4 4 5 4 4 4 4 4 6 4 4 4 6 4 
4 4 6 4 4 12 4 4 4 7 0 4 4 4 11 11 4 4 4 4 6 4 4 5 4 4 4 4 4 4 4 4 4 4 4 4 4 7 5 4 4 4 4 4 4 4 4 4 4 4 
4 4 4 4 12 12 4 4 0 0 0 4 4 4 6 6 4 4 6 4 4 4 4 5 4 4 4 4 6 4 4 4 4 4 11 4 4 7 5 4 4 4 12 12 12 4 4 4 4 4 
4 4 4 4 4 4 4 4 0 7 4 4 4 4 4 4 4 4 4 4 4 4 4 5 4 4 4 4 4 4 4 4 4 4 4 4 8 4 5 4 4 4 12 12 4 4 4 6 6 4 
4 4 6 6 6 4 4 11 0 4 4 10 10 4 4 4 6 4 4 4 4 6 0 5 0 6 4 4 12 12 4 6 4 4 4 4 5 5 5 8 4 4 4 4 4 4 4 4 4 4 
4 4 6 6 6 4 4 4 0 4 4 10 10 4 4 4 4 4 4 11 11 0 0 5 0 0 11 11 4 4 4 4 4 11 4 4 5 4 4 4 4 4 4 4 6 4 4 4 4 4 
4 4 4 4 4 4 4 4 0 4 4 4 4 4 6 4 4 4 6 6 0 0 0 5 0 0 0 6 6 4 4 4 4 4 4 5 5 4 4 4 4 4 4 4 4 4 4 4 4 4 
4 4 4 4 4 4 4 4 0 4 4 4 5 5 5 5 5 5 5 5 5 5 5 5 5 5 5 5 5 5 5 5 5 5 5 5 5 4 4 4 4 4 4 6 4 4 4 4 6 4 
4 4 11 11 11 4 4 4 0 10 4 4 0 4 6 4 4 4 4 6 0 0 0 5 0 0 0 6 4 4 4 4 4 4 4 4 5 4 4 4 11 4 4 4 4 4 4 4 4 4 
4 4 11 11 11 4 4 4 0 10 4 4 0 4 4 4 4 4 4 4 11 0 0 5 0 0 11 4 4 4 4 4 4 4 4 4 5 4 4 4 11 6 4 4 6 4 4 4 4 4 
4 4 4 4 4 4 4 4 0 4 4 4 0 7 4 4 6 4 4 4 4 6 0 5 0 6 4 4 4 4 6 4 4 4 4 4 5 4 4 4 4 4 4 4 4 4 4 4 4 4 
9 9 4 4 4 4 4 4 0 4 4 4 0 0 0 4 4 4 4 4 4 4 4 5 4 4 4 4 4 6 6 4 4 4 4 4 5 6 4 4 4 4 4 4 4 4 4 11 11 4 
9 9 4 4 4 4 4 11 0 4 4 4 4 4 0 4 4 6 4 4 4 4 4 5 4 4 4 8 6 6 4 4 4 4 4 4 5 4 6 6 4 4 4 4 4 4 4 4 11 4 
9 9 4 4 6 4 4 4 0 4 4 4 4 4 0 4 4 4 4 4 4 4 4 5 4 4 4 8 4 4 4 4 4 4 4 7 5 4 4 4 4 4 4 4 4 6 4 4 4 4 
4 4 4 6 6 6 4 4 0 7 4 4 4 4 0 4 4 4 4 4 4 4 4 5 4 12 4 4 4 4 8 4 4 4 4 4 5 4 4 4 10 10 4 4 4 4 4 4 4 4 
4 4 4 4 4 4 4 4 0 0 0 0 0 0 0 4 4 6 4 4 4 4 4 5 4 12 4 4 4 4 8 4 4 4 4 4 5 4 4 4 10 10 4 4 6 4 4 4 4 4 
4 4 4 4 4 4 4 4 0 9 0 0 0 0 0 4 4 4 4 4 4 4 6 5 4 12 4 4 4 4 6 4 4 4 4 4 0 4 4 4 4 4 4 4 4 4 4 4 4 4 
4 4 4 4 6 4 4 4 0 0 0 0 0 0 0 4 4 4 4 4 4 4 4 5 4 4 4 4 4 4 4 4 4 4 4 0 0 0 4 4 4 4 6 4 4 4 4 4 4 4 
4 4 4 4 4 4 4 4 0 0 0 0 0 0 0 4 4 4 4 6 4 4 4 5 4 4 4 6 4 4 4 6 4 4 4 0 0 0 4 4 4 6 4 4 4 4 4 4 4 4 
4 4 4 12 12 12 4 4 0 0 0 0 0 9 0 4 4 4 4 4 4 4 4 5 4 4 4 4 4 4 4 4 4 4 4 0 0 0 4 4 4 4 4 4 4 4 4 4 11 4 
4 8 4 4 4 4 4 7 0 0 0 0 0 0 0 7 4 4 4 4 4 4 4 5 4 4 4 4 4 4 4 4 4 9 4 0 0 0 4 4 4 4 4 4 4 4 6 4 11 4 
8 8 4 4 4 4 4 4 4 4 4 4 4 4 4 4 4 4 4 4 4 4 4 5 4 4 4 4 4 4 4 4 4 4 4 0 0 0 9 4 4 6 4 4 4 4 6 4 4 4 
4 4 11 4 4 4 4 4 4 4 4 4 4 4 4 4 4 4 4 0 0 0 0 0 0 0 0 4 4 4 4 4 4 4 0 0 0 0 0 4 4 4 4 4 4 4 6 4 4 4 
4 4 4 4 4 4 4 4 6 6 6 4 4 4 4 4 4 4 0 0 0 0 0 0 0 0 0 0 4 4 0 4 4 0 0 0 0 0 0 6 4 4 8 8 4 4 4 4 4 4 
10 4 4 4 4 4 4 4 4 4 4 4 4 4 4 4 4 4 0 0 9 0 0 0 0 0 0 0 4 4 4 4 0 0 0 0 0 0 6 4 4 8 8 8 4 4 4 4 4 4 
4 4 4 4 8 8 4 4 4 4 4 4 4 4 4 4 4 4 0 0 0 0 0 0 0 0 0 0 0 4 4 4 0 0 0 0 0 7 0 4 4 4 4 8 4 4 4 4 4 4 
4 11 4 4 4 4 4 4 4 11 4 4 4 4 4 4 4 4 0 0 0 0 0 0 0 9 0 0 0 0 0 0 0 0 7 0 0 0 0 4 4 4 4 4 4 4 4 4 4 4 
4 4 4 4 12 4 4 6 4 4 4 6 4 4 4 4 4 4 6 0 0 0 0 0 0 0 0 7 4 4 4 0 0 0 0 0 0 0 0 4 4 4 4 4 4 4 4 4 4 4 
8 4 4 4 4 4 6 6 6 4 4 4 10 4 4 4 4 4 6 6 0 0 0 0 0 0 4 4 4 4 4 0 0 7 0 0 7 0 0 4 4 4 6 6 6 6 4 4 4 4 
8 8 4 4 4 4 4 6 4 4 4 4 10 4 4 4 4 4 4 4 7 7 4 4 4 4 4 4 4 4 4 4 0 0 0 0 0 0 4 4 4 4 4 4 4 6 4 4 4 4 
4 4 6 4 4 6 4 4 4 4 4 4 4 4 4 4 4 4 4 4 4 4 4 11 4 4 4 4 4 4 4 4 4 4 4 4 4 4 4 4 4 4 4 4 4 4 4 4 4 4 
4 6 6 6 6 6 6 12 12 12 6 4 4 4 4 6 4 4 4 4 4 6 4 4 4 12 12 4 4 4 4 4 4 6 4 4 4 4 6 4 4 4 4 4 4 4 4 4 4 4 
4 6 6 6 6 12 12 12 12 12 4 4 4 4 4 10 4 4 4 4 4 4 4 4 4 12 12 4 4 4 4 4 4 4 4 4 10 4 4 4 4 4 4 4 4 4 4 4 4 4 
4 4 4 4 4 4 4 4 12 12 11 4 4 4 4 4 4 4 4 4 4 4 4 4 4 4 4 4 4 4 4 4 4 4 4 10 10 4 4 4 4 4 4 4 6 4 4 4 4 4 
4 11 4 4 4 4 4 4 4 4 4 4 8 4 4 4 11 4 4 4 6 4 4 4 4 4 4 4 4 4 4 6 6 4 10 10 4 4 6 4 4 4 4 6 6 4 4 4 4 4 
4 4 4 6 4 4 6 4 4 4 8 8 8 4 4 4 4 4 4 6 6 6 4 4 4 4 6 6 4 4 6 6 6 4 4 4 4 4 4 4 4 4 4 4 4 4 4 4 4 4 
